ET TE   T      T    T TTT   T  TT    T  
           T  T  TT  E       T       EE 
   T         ET T  T     T T TET T  E TE
  T    T E E E  T  T              T  T E
  TET   TC T ET   T       T     T       
TT T  TT E    E    TTT  TT E  E  TE   TT
  T TT EE TT                   E  T     
T   TEE T T              E            T 
    TT    TE  T T   EE         T  T T TT
 T   TTEET TEE TT   T    TT   TT T  TTTT
   E     T T   E       T    TE         T
T EE    EET  E         ET    T     TTTEE
E  E T E   T E  TE    T E   TT E        
   ET T  T    TT   ETTT T   T           
TT  EEE T    T  T   T   T  T T   T  E   
  E TE   E E      T T           T       
  E T ETT      TE T    E  E        E    
  E TT    E T        ET  E    E E  TT   
TE    T   T  E T  T   T     T TET   T   
 TET    EE E    TT                   T  
